{"BlockSize": 16,
 "Number": 1,
 "Map01": {"Name": "Map01",
           "00": {"Name": "00",
                  "Cols": 9,
                  "Rows": 9,
                  "Map": [[11, 10, 11, 10, 11, 10, 11, 10, 11],
                          [15, 12, 13, 12, 13, 12, 13, 14, 15],
                          [11, 5, 8, 9, 1, 2, 5, 10, 11],
                          [15, 3, 10, 11, 2, 5, 1, 12, 13],
                          [11, 7, 12, 13, 1, 5, 2, 7, 2],
                          [15, 5, 3, 2, 2, 8, 9, 1, 5],
                          [11, 7, 5, 3, 5, 10, 11, 7, 2],
                          [15, 8, 9, 8, 9, 14, 15, 8, 9],
                          [11, 10, 11, 10, 11, 10, 11, 10, 11]],
                  "Behavior": [[0, 0, 0, 0, 0, 0, 0, 0, 0],
                               [0, 0, 0, 0, 0, 0, 0, 0, 0],
                               [0, 0, 0, 0, 0, 0, 0, 0, 0],
                               [0, 0, 0, 0, 0, 0, 0, 0, 0],
                               [0, 0, 0, 0, 0, 0, 0, 0, 0],
                               [0, 0, 0, 0, 0, 0, 0, 0, 0],
                               [0, 0, 0, 0, 0, 0, 0, 0, 0],
                               [0, 0, 0, 0, 0, 0, 0, 0, 0],
                               [0, 0, 0, 0, 0, 0, 0, 0, 0]],
                  "HitBox": [[1, 1, 1, 1, 1, 1, 1, 1, 1],
                             [1, 1, 1, 1, 1, 1, 1, 1, 1],
                             [1, 0, 0, 0, 0, 0, 0, 1, 1],
                             [1, 0, 1, 1, 0, 0, 0, 1, 1],
                             [1, 1, 1, 1, 0, 0, 0, 1, 0],
                             [1, 0, 0, 0, 0, 0, 0, 0, 0],
                             [1, 1, 0, 0, 0, 1, 1, 1, 0],
                             [1, 0, 0, 0, 0, 1, 1, 0, 0],
                             [1, 1, 1, 1, 1, 1, 1, 1, 1]],
                  "Background": [10, 11, 14, 15],
                  "BGLocation": "rasset/Maps/01/MBG-00.gif",
                  "Location": "rasset/Maps/01/M1-00.gif",
                  "Location2": "rasset/Maps/01/M2-00.gif",
                  "Location3": "rasset/Maps/01/M3-00.gif"}}}